color.RandomGreenGenerator
hw4.SquareMap 30
-----------###-----------
--####-------------####--
--#-------------------#--
--#--####---#---####--#--
--#---------#---------#--
--#---------#---------#--
------------#------------
---------#######---------
-------------------------
------------S-----D------
-------------------------
---------#######---------
------------#------------
--#---------#---------#--
--#---------#---------#--
--#--####---#---####--#--
--#-------------------#--
--####-------------####--
-----------###-----------
